## ## ## ## ## ## ## ##
## rn nn nn nn nn nn $$
## nn ## ## ## ## nn ##
## nn ## ## ## ## nn ##
## nn nn nn nn nn nR ##
## ## ## ## ## ## ## ##