nn nn nn ## ## ## nn nn nn nn nn
nn nn nn ## nn ## ## ## ## ## ##
## ## ## ## nn nn nn nn nn nn ##
## nn ## nn nn nn nn ## nn nn ##
## nn nn nR nn nn nn nn nn nn ##
## rn nn nn nn nn ## nn nn nn ##
## nn nn nn nn ## ## ## ## ## ##
## nn nn nn nn ## nn nn nn nn nn
## ## ## ## ## ## nn nn nn nn nn