n n n n # # # # #
n n n n # n n n #
# # # # # R # n #
# n n n r n # n #
# n n B # b # n #
# n n n n n n n #
# n n n n n n n #
# # # # # # # # #