nn nn nn nn nn nn nn nn ## ## ## ##
## ## ## ## ## nn nn ## ## nn nP ##
## nW nB nY ## ## ## ## nn nn nn ##
## nn nn nn bn pn yn rn nn nn nn ##
## ## ## ## ## ## ## ## ## ## ## ##