n # # # n n n n
# # Y # # # # #
# y r b n n n #
# B # R # # # #
# # # # # n n n