n # # # # # # #
n # n n n n n #
n # n B n # n #
# # n # # # n #
# n y r b n n #
# n # # # # n #
# n # n Y # R #
# n n n n n n #
# # # # # # # #
